44,42,42,43,44,42,42,43,43,42,42,44,44,42,44,42,43,44
43,42,44,42,44,42,43,42,44,43,44,44,42,42,43,43,44,42
44,42,43,43,42,44,43,44,44,43,42,43,44,42,43,43,44,43
42,44,44,42,42,43,43,43,43,42,44,44,43,43,44,42,42,44
44,44,44,43,43,42,42,43,44,42,43,42,44,42,44,42,44,43
42,42,44,43,42,42,42,44,44,42,42,44,43,44,43,43,42,42
42,44,43,44,44,42,43,43,42,43,43,44,43,42,42,42,42,42
42,42,42,44,43,42,44,44,42,43,43,44,44,43,42,42,43,44
43,42,44,42,43,42,44,43,42,43,42,42,43,44,42,43,43,42
42,43,43,44,42,42,42,43,44,44,43,43,42,44,42,44,44,42
44,44,43,43,42,44,43,44,42,43,44,42,44,42,44,44,42,43
42,42,42,42,44,42,43,44,43,44,43,44,44,43,43,44,44,43
43,44,43,42,43,42,44,43,44,43,42,43,42,43,42,44,43,42
44,42,42,43,44,44,43,42,43,42,42,42,42,43,42,42,42,42
44,42,44,43,44,44,43,43,42,42,43,43,43,42,42,42,42,42
43,44,42,44,43,44,42,44,44,42,43,44,43,42,44,44,44,44
42,44,42,44,43,42,42,42,43,44,44,42,43,44,44,44,42,42
43,44,42,42,42,44,42,42,44,44,44,44,42,44,42,44,42,42
